XXXXXXXXXXXXXXXXXXXX
X P                X
X XXXXXXXXXXXXXXXX X
X X    X   X   X   X
X X  X   X   X   X X
X X  XXXXXXXXXXXXX X
X X      X         X
X XXXXXX XXXXXXXXX X
X        XXXX      X
XXXXXXXXXXXXXDXXXXXX