XXXXXXXXXXXXXXXXXXXX
X P                X
X XXXXXXXXXXXXXXXX X
X X                X
X X XXXXXXXXXXXX X X
X X XXXXXXXXXXXX X X
X X      X       X X
X XXXXXXXX XXXXXXX X
X        X X       X
XXXXXXXXXXDXXXXXXXXX