XXXXXXXXXXXXXXXXX
X   X           X
X X X XXXX XXXX X
X X X   X     X X
X X XXXCX XXX XDX
X XCX XXX X X XXX
X XXX     X X D N
XP  X X X X X X X
XXX XXXXX X     X
XCX       XX XXXX
X XXXXXXXXDX XXCX
X               X
XXXXXXXXXXXXXXXXX