XXXXXXXXXXDXXXXXXXXX
XXXXXXX      XXXXXXX
XXXXXXX      XXXXXXX
X        XX        X
X  XXXXXXXXXXXXXX  X
X        XX        X
XXXXXXX      XXXXXXX
XXXXXXX      XXXXXXX
XXXXXXX      XXXXXXX
XXXXXXXXXXDXXXXXXXXX