XBXXXXXXXXXXXXXNX
XPXC          X X
X XX XXXXXXDX X X
X    X        X X
XXX XXXCXXXXXXX X
XCX XDXXD       X
X X X   X X X XXX
X X X XCX X X XCX
X   X XXX X X X X
X X X   X X X   X
X XXX XXX X XXXXX
X         X    CX
XXXXXXXXXXXXXXXXX