XXXXXXXXXXXXXDXXXXXX
X                  X
X XXXXXXXXXXXXXXXX X
X        X   X   X X
X  XXXXXXX X X X X X
X        X X X X X X
XXXXXXXX X X X X X X
X        X X X X X X
XXXXXXXXXX X   X   X
XXXXXXXXXXDXXXXXXXXX