XXXXXXXXXXDXXXXXXXXX
XXXXXXXX     XXXXXXX
XXXXXXXX     XXXXXXX
XXXXXXXXX   XXXXXXXX
XXXXXXXX     XXXXXXX
XXXXXXXX     XXXXXXX
XXXXXXXXX   XXXXXXXX
XXXXXXXX     XXXXXXX
XXXXXXXX     XXXXXXX
XXXXXXXXXXDXXXXXXXXX