XXXXXXXXXXXXXXXXXXXX
XXXXX          XXXXX
XXXXX XXXXXX X XXXXX
XXXX  XXXX X   XXXXX
XP  X XXXX   X     #
XXX        XX   XXXX
XXXXXXXXXX XXXXXXXXX
XXXXXXXXXX         #
XXXXXXXXXXXXXXXXXXXX
XXXXXXXXXXXXXXXXXXXX