XXXXXXXXXXDXXXXXXXXX
X                  X
X XXXXXXXXXXXXXXX  X
X     X            X
XXXXX X XXXXXXXXXXXX
X   X X            X
X X X XXXXXXXXXXXX X
X X X X  X    X    X
X X   X     X   X  X
XDXXXXXXXXXXXXXXXXXX