XXXXXXBXXXXXXXXXX
X    XPX        X
X X X  XXX XXXX X
X X X X X     XCX
X X X XCX XXX XDX
XXX   XXX X X XXX
X X X     X X   D
B X X X XXX X X X
X   X X X X  XXXX
X X X X   XX XC X
X X X XXXXDX XX X
X X X           X
XXXXXXXXXXXXXXXXX