XXXXXXXXXXDXXXXXXXXX
X                 XX
X X X X X X X X X XX
X X X X X X X X X XX
X X X X X X X X X XX
X X X X X X X X X XX
X X X X X X X X X XX
X X X XXXXXXX X X XX
X X X      XX     XX
XXXXXXXXXXDXXXXXXXXX