XXXXXXXXXXXXXXXXXXXX
XXXXXXXXXXXXXXXXXXXX
XXXXXXXXXXXXXXXXXXXX
XXXXXXXXXX X   XXXXX
XP  X XXXX   X     X
XXX        XXXX XX X
XXX XXXXXXXXXXX XX #
XXX          X  XXXX
XXXXXXXX XXX   XXXXX
XXXXXXXXXXXXXXXXXXXX