XDXXXXXXXXXXXXXXXXXX
X                 XX
X X X X X X X X X XX
X X X X X X X X X XX
X X X X X X X X X XX
X X X X X X X X X XX
X X X X X X X X X XX
X X XXXXXXXXX X X XX
X X XXXX      X   XX
XXXXXXXXXXDXXXXXXXXX