XXXXXXXXXXDXXXXXXXXX
X                  X
XXXXXXXXXXXXXXXXX  X
X                  X
X  XXXXXXXXX  XXXX X
X          X  X  X X
X  XXXXXXXXX  X  X X
X  X   X   X  X  X X
X    X   X X     X X
XXXXXXXXXXDXXXXXXXXX