XXXXXXXXXXXXXXXXXXXX
XXXXXXXXXXXXXXXXXXXX
XP   XXXXXXXXXXXXX #
XXXX XX     XXXXX  X
XXXX XX XXX XX    XX
XXXX    XXX XX XXXXX
XXXXXXXXXXX XX XXXXX
XXXXXXXXXXX    XXXXX
XXXXXXXXXXX XX     #
XXXXXXXXXXXXXXXXXXXX