XXXXXXXXXXXXXXXXXXXX
XXXX             XXX
XXXX XXXXXXXXXXXXXXX
XXXX  XXXX X   XXXXX
XP  X XXXX   X     #
XXX     X  XX   XXXX
XXXXXX XXXXXXXXXX  #
XXXXXX       XXXX XX
XXXXXXXXXXXX      XX
XXXXXXXXXXXXXXXXXXXX